Men of Vizion - Personal - All Tracks
Instant love=Men of Vizion
Do Thangz=Men of vizion
When You Need Someone=Men of Vizion
Joyride feat. tasha Scott=Men of Vizion
You Told Me You Loved Me=Men of Vizion
Show You The Way To Go=Men of Vizion
Night and Day=Men of Vizion
All I See=A+
Booti Call=Blackstreet
Got to be Real=Cheryl Lynn
Love to Love you=On The Contrary
If I changed my mind=Ebony Foster
Sweet Music=Bobby Ross
That's the way is goin'down=Mint Condition
The way make me feel=Donnel Jones
You'll want me back=Ferg feat. Gina Cano
Twisted=keith Sweat
It's on Tonight=Tracie Spencer feat. Busta Rhymes
One on One=Mc. Lite
Surrender=Shola Ama
Taboo=Shola Ama
What you want 2 It's a party=[Dr Do litle OST] Busta Rhymes feat. Zhan
My Booky=Jennifer
Weekend Thing=Koffee Brown
Act thing you know=Nathalie Wilson
Game Plain=Me One
Ribbon in the sky=2 men 4 soul
Rashan Paterson=Where you are?
R. Kelly=Use to my spending
Mc. Hammer=Bump's and bump